"filename", "language", "Markdown", "Java", "XML", "comment", "blank", "total"
"c:\cygwin64\home\sotir\repo\programming-project\README.md", "Markdown", 2, 0, 0, 0, 1, 3
"c:\cygwin64\home\sotir\repo\programming-project\checkstyle.xml", "XML", 0, 0, 54, 0, 15, 69
"c:\cygwin64\home\sotir\repo\programming-project\shipdis\pom.xml", "XML", 0, 0, 84, 4, 11, 99
"c:\cygwin64\home\sotir\repo\programming-project\shipdis\src\main\java\thecode\AddDestinationListener.java", "Java", 0, 28, 0, 0, 5, 33
"c:\cygwin64\home\sotir\repo\programming-project\shipdis\src\main\java\thecode\App.java", "Java", 0, 9, 0, 0, 2, 11
"c:\cygwin64\home\sotir\repo\programming-project\shipdis\src\main\java\thecode\ClearListListener.java", "Java", 0, 14, 0, 0, 5, 19
"c:\cygwin64\home\sotir\repo\programming-project\shipdis\src\main\java\thecode\CruiseInput.java", "Java", 0, 87, 0, 10, 27, 124
"c:\cygwin64\home\sotir\repo\programming-project\shipdis\src\main\java\thecode\GreekPorts.java", "Java", 0, 57, 0, 5, 14, 76
"c:\cygwin64\home\sotir\repo\programming-project\shipdis\src\main\java\thecode\Optimization.java", "Java", 0, 56, 0, 0, 12, 68
"c:\cygwin64\home\sotir\repo\programming-project\shipdis\src\main\java\thecode\Port.java", "Java", 0, 25, 0, 0, 6, 31
"c:\cygwin64\home\sotir\repo\programming-project\shipdis\src\main\java\thecode\SubmitDataListener.java", "Java", 0, 44, 0, 0, 7, 51
"c:\cygwin64\home\sotir\repo\programming-project\shipdis\src\main\resources\checkstyle.xml", "XML", 0, 0, 54, 0, 15, 69
"c:\cygwin64\home\sotir\repo\programming-project\shipdis\src\test\java\thecode\AppTest.java", "Java", 0, 11, 0, 6, 4, 21
"c:\cygwin64\home\sotir\repo\programming-project\shipdis\target\checkstyle-checker.xml", "XML", 0, 0, 96, 76, 27, 199
"c:\cygwin64\home\sotir\repo\programming-project\shipdis\target\checkstyle-result.xml", "XML", 0, 0, 281, 0, 1, 282
"c:\cygwin64\home\sotir\repo\programming-project\shipdis\target\classes\checkstyle.xml", "XML", 0, 0, 54, 0, 15, 69
"c:\cygwin64\home\sotir\repo\programming-project\shipdis\target\classes\thecode\AddDestinationListener.class", "Java", 0, 26, 0, 0, 0, 26
"c:\cygwin64\home\sotir\repo\programming-project\shipdis\target\classes\thecode\App.class", "Java", 0, 8, 0, 0, 0, 8
"c:\cygwin64\home\sotir\repo\programming-project\shipdis\target\classes\thecode\ClearListListener.class", "Java", 0, 13, 0, 0, 0, 13
"c:\cygwin64\home\sotir\repo\programming-project\shipdis\target\classes\thecode\CruiseInput.class", "Java", 0, 51, 0, 0, 0, 51
"c:\cygwin64\home\sotir\repo\programming-project\shipdis\target\classes\thecode\GreekPorts.class", "Java", 0, 57, 0, 0, 0, 57
"c:\cygwin64\home\sotir\repo\programming-project\shipdis\target\classes\thecode\Optimization.class", "Java", 0, 31, 0, 2, 0, 33
"c:\cygwin64\home\sotir\repo\programming-project\shipdis\target\classes\thecode\Port.class", "Java", 0, 15, 0, 0, 0, 15
"c:\cygwin64\home\sotir\repo\programming-project\shipdis\target\classes\thecode\SubmitDataListener.class", "Java", 0, 13, 0, 0, 1, 14
"c:\cygwin64\home\sotir\repo\programming-project\shipdis\target\test-classes\thecode\AppTest.class", "Java", 0, 11, 0, 0, 0, 11
"Total", "-", 2, 556, 623, 103, 168, 1452