"filename", "language", "XML", "Markdown", "Java", "comment", "blank", "total"
"c:\cygwin64\home\sotir\repo\programming-project\README.md", "Markdown", 0, 2, 0, 0, 1, 3
"c:\cygwin64\home\sotir\repo\programming-project\checkstyle.xml", "XML", 54, 0, 0, 0, 15, 69
"c:\cygwin64\home\sotir\repo\programming-project\shipdis\pom.xml", "XML", 84, 0, 0, 4, 11, 99
"c:\cygwin64\home\sotir\repo\programming-project\shipdis\src\main\java\thecode\AddDestinationListener.java", "Java", 0, 0, 28, 0, 5, 33
"c:\cygwin64\home\sotir\repo\programming-project\shipdis\src\main\java\thecode\App.java", "Java", 0, 0, 9, 0, 2, 11
"c:\cygwin64\home\sotir\repo\programming-project\shipdis\src\main\java\thecode\ClearListListener.java", "Java", 0, 0, 14, 0, 5, 19
"c:\cygwin64\home\sotir\repo\programming-project\shipdis\src\main\java\thecode\CruiseInput.java", "Java", 0, 0, 76, 10, 22, 108
"c:\cygwin64\home\sotir\repo\programming-project\shipdis\src\main\java\thecode\GreekPorts.java", "Java", 0, 0, 57, 5, 14, 76
"c:\cygwin64\home\sotir\repo\programming-project\shipdis\src\main\java\thecode\Optimization.java", "Java", 0, 0, 56, 0, 12, 68
"c:\cygwin64\home\sotir\repo\programming-project\shipdis\src\main\java\thecode\Port.java", "Java", 0, 0, 25, 0, 6, 31
"c:\cygwin64\home\sotir\repo\programming-project\shipdis\src\main\java\thecode\SubmitDataListener.java", "Java", 0, 0, 44, 0, 7, 51
"c:\cygwin64\home\sotir\repo\programming-project\shipdis\src\main\resources\checkstyle.xml", "XML", 54, 0, 0, 0, 15, 69
"c:\cygwin64\home\sotir\repo\programming-project\shipdis\src\test\java\thecode\AppTest.java", "Java", 0, 0, 11, 6, 4, 21
"c:\cygwin64\home\sotir\repo\programming-project\shipdis\target\checkstyle-checker.xml", "XML", 96, 0, 0, 76, 27, 199
"c:\cygwin64\home\sotir\repo\programming-project\shipdis\target\checkstyle-result.xml", "XML", 281, 0, 0, 0, 1, 282
"c:\cygwin64\home\sotir\repo\programming-project\shipdis\target\classes\checkstyle.xml", "XML", 54, 0, 0, 0, 15, 69
"c:\cygwin64\home\sotir\repo\programming-project\shipdis\target\classes\thecode\AddDestinationListener.class", "Java", 0, 0, 15, 0, 1, 16
"c:\cygwin64\home\sotir\repo\programming-project\shipdis\target\classes\thecode\AntColony.class", "Java", 0, 0, 22, 0, 1, 23
"c:\cygwin64\home\sotir\repo\programming-project\shipdis\target\classes\thecode\App.class", "Java", 0, 0, 8, 0, 0, 8
"c:\cygwin64\home\sotir\repo\programming-project\shipdis\target\classes\thecode\ClearListListener.class", "Java", 0, 0, 13, 0, 0, 13
"c:\cygwin64\home\sotir\repo\programming-project\shipdis\target\classes\thecode\CruiseInput.class", "Java", 0, 0, 51, 0, 0, 51
"c:\cygwin64\home\sotir\repo\programming-project\shipdis\target\classes\thecode\GreekPorts.class", "Java", 0, 0, 57, 0, 0, 57
"c:\cygwin64\home\sotir\repo\programming-project\shipdis\target\classes\thecode\Optimization.class", "Java", 0, 0, 31, 2, 0, 33
"c:\cygwin64\home\sotir\repo\programming-project\shipdis\target\classes\thecode\Port.class", "Java", 0, 0, 15, 0, 0, 15
"c:\cygwin64\home\sotir\repo\programming-project\shipdis\target\classes\thecode\ShipRouteOptimizer.class", "Java", 0, 0, 11, 0, 1, 12
"c:\cygwin64\home\sotir\repo\programming-project\shipdis\target\classes\thecode\SubmitDataListener.class", "Java", 0, 0, 16, 0, 1, 17
"c:\cygwin64\home\sotir\repo\programming-project\shipdis\target\classes\thecode\Διαδρομή.class", "Java", 0, 0, 14, 0, 1, 15
"c:\cygwin64\home\sotir\repo\programming-project\shipdis\target\classes\thecode\Πόλη.class", "Java", 0, 0, 11, 0, 1, 12
"c:\cygwin64\home\sotir\repo\programming-project\shipdis\target\test-classes\thecode\AppTest.class", "Java", 0, 0, 11, 0, 0, 11
"Total", "-", 623, 2, 595, 103, 168, 1491